D,D,D,D,D,D,D,D,D,D,D,D,D,D,D
D,S,S,S,S,S,S,S,S,S,S,S,S,S,D
D,S,O,S,S,S,S,S,S,S,P,S,S,S,D
D,S,S,S,S,S,S,S,S,S,S,S,S,S,D
D,S,S,S,S,S,S,S,S,S,S,S,S,S,D
D,S,S,K,S,S,S,S,S,S,S,S,S,S,D
D,S,S,S,S,S,S,S,S,S,D,S,S,S,D
D,S,S,S,S,S,R,R,S,S,S,S,S,S,D
D,S,S,S,S,S,S,S,S,S,S,S,S,S,D
D,S,S,S,S,S,S,S,S,S,S,S,S,S,D
D,S,S,S,S,S,S,S,S,S,S,S,S,S,D
D,S,S,S,S,S,S,S,S,S,S,S,S,S,D
D,S,P,S,S,S,S,S,S,S,S,O,S,S,D
D,S,S,S,S,S,S,S,S,S,S,S,S,S,D
D,D,D,D,D,D,D,D,D,D,D,D,D,D,D